111111111111111111111
1...................1
1...................1
1...................1
1...................1
1...................1
1.P....RRRR.........1
1......RRRR.........1
1...................1
1...................1
1...................1
1...............W...1
111111111111111111111