1111111111111111111
1.................1
1.................1
1.................1
1.................1
1.................1
1.P....RRRR.......1
1......RRRR....W..1
1111111111111111111