1111111111111111111
1..R......R....1..1
1..R.......11..1..1
1..........11..1..1
1...........1..RRR1
1..1..........RRRR1
1..111.....RRRR1111
1.....1....RRR1...1
1111111111111111111