1111111111111111111
1.................1
1.................1
1.................1
1.....RRRRR.......1
1.....RRRRR.......1
1.....RRRRR.......1
1.....RRRRR.......1
1111111111111111111