1111111111111
1...........1
1...........1
1.....11....1
1.....1.1...1
1....11..1..1
1.....1...1.1
111...1.....1
1.....1.....1
1....11....11
1.....1.RR1.1
1...1.1.R1..1
1.....1.1...1
11....1.....1
1..1..1.....1
1..P.111.....
1.....1.1....
1111111111111