11111111111111
1....GGG.....1
1....GGG.....1
1....GGG..1.W1
1....GGG..1111
1....GGG.....1
1.P..GGG.....1
1....GGG.....1
11111111111111