111111111111111111111
1...................1
1...................1
1.....GGG111........1
1.....GGGGGG..RRRR..1
1.....GGGGGG..RRRR.W1
1.....GGG.....1111111
1.....GGG...........1
1...P.GGG...........1
1.....GGG...........1
111111111111111111111