1111111111111111111111111
1...........1..GGG......1
1...........1..GGG......1
1.....11....1.....11111.1
1.....1.1...1.....1.....1
1....11..1..1.11..1.....1
1.....1...1.1G....1.11111
111...1.....1.....1.....1
1.....1.....1111GG1.....1
1....11....11GGGGG11111.1
1.....1.RR1.1GGGGG1.....1
1...1.1.R1..1G11111.....1
1.....1.1...1.....1.11111
11....1.....1.....1......
1..1..1.....1111G.1......
1.P..111..........1...111
1.....1.1.........1.....1
1111111111111111111111111