11111111111111111
1.............gg1
1.............gg1
1.............gg1
1.............gg1
1.............gg1
1......P......gg1
1.............gg1
11111111111111111